39 17
04 11 11 10 10 11 10 10 11 11 10 10 03 11 11 10 10 11 03 10 11 11 10 10 10 03 11 11 10 10 11 10 10 11 11 10 10 10 03
07 02 00 00 00 00 02 00 00 00 00 02 07 02 00 00 00 00 07 00 00 00 00 00 02 07 02 00 00 00 00 00 00 00 00 00 00 02 07
07 13 13 13 13 13 13 13 13 13 13 13 08 13 13 13 13 13 07 13 13 13 13 13 13 08 13 13 13 13 13 13 13 13 13 13 13 13 07
07 13 13 13 13 13 13 13 02 02 13 13 00 13 13 13 13 13 08 13 13 13 13 13 13 02 13 13 13 13 13 13 13 13 13 13 13 13 07
06 13 13 13 13 13 13 13 16 16 13 13 13 13 13 13 13 13 02 13 13 13 13 13 13 13 13 13 13 13 13 13 13 13 13 13 13 13 06
08 13 13 13 13 13 13 13 16 16 13 13 15 13 13 13 13 13 13 13 13 13 13 13 13 09 13 13 13 13 13 13 13 13 13 13 13 13 06
17 17 17 17 18 17 17 17 16 16 18 17 17 17 17 17 17 18 17 17 17 17 17 17 18 03 10 11 11 10 10 12 13 04 10 11 10 10 03
16 16 16 16 16 16 16 16 16 16 16 16 16 16 16 16 16 16 16 16 16 16 16 16 16 07 02 00 00 00 00 02 13 08 00 00 00 00 06
16 16 16 10 11 10 11 10 11 12 16 16 13 13 13 15 13 14 14 14 13 15 13 13 16 08 17 17 18 17 17 13 14 02 15 13 13 13 06
16 16 16 02 00 00 02 00 00 02 16 16 17 14 15 15 13 14 13 15 14 14 15 17 16 16 16 16 16 16 16 17 15 14 14 15 13 13 08
09 16 16 16 16 16 16 16 16 16 16 16 13 13 13 15 13 14 15 14 15 14 13 13 13 13 13 13 15 13 14 15 14 15 14 13 13 13 00
03 10 11 16 16 14 13 13 13 13 13 13 13 13 04 11 10 10 10 10 10 10 11 10 10 11 10 11 11 10 10 10 10 10 10 11 10 10 03
08 02 00 16 16 17 13 13 13 13 13 13 04 12 08 00 00 00 00 02 00 00 00 00 00 07 00 00 00 00 00 00 00 00 00 00 00 00 06
00 00 00 16 16 14 13 15 14 14 15 13 08 00 00 15 13 14 14 14 13 15 13 13 13 08 13 13 15 13 14 14 14 13 15 13 13 13 06
00 00 00 16 16 17 14 14 13 15 13 13 02 14 15 15 13 14 13 15 14 14 15 13 13 02 14 15 15 13 14 13 15 14 14 15 13 13 08
16 16 16 16 16 14 15 14 15 14 13 13 13 13 13 15 13 14 15 14 15 14 13 13 13 13 13 13 15 13 14 15 14 15 14 13 13 13 00
16 16 16 16 16 01 01 01 01 01 18 01 01 01 01 01 01 01 18 01 01 01 01 01 01 01 01 01 01 01 01 18 01 01 01 01 01 01 01
