39 17
04 11 11 10 10 11 10 10 11 11 10 10 03 11 11 10 11 11 11 11 11 10 10 10 10 03 11 11 10 10 03 10 10 11 11 10 10 10 03
07 02 00 00 00 00 02 00 00 00 00 00 08 00 00 02 00 00 00 00 00 00 00 02 00 07 02 00 00 00 07 00 00 00 00 00 00 02 07
07 00 00 00 00 00 00 00 00 00 00 00 00 00 00 00 00 00 00 00 00 00 00 00 00 08 13 14 15 13 07 00 02 00 00 00 02 00 08
08 13 14 15 13 14 15 13 13 14 15 13 14 15 13 15 00 00 00 00 00 00 00 13 13 02 13 15 14 13 08 13 14 14 13 14 13 14 02
02 14 15 13 13 13 15 13 13 15 13 14 15 14 15 18 16 16 16 16 16 16 16 18 14 15 14 13 13 15 02 13 15 15 13 15 13 15 13
13 15 14 13 13 13 14 13 13 14 13 15 14 13 14 15 20 20 20 20 20 20 20 14 15 14 13 13 13 14 13 13 13 13 13 13 13 13 14
18 17 17 17 17 17 17 17 17 17 17 17 17 17 17 18 16 16 16 16 16 16 16 15 13 18 19 18 17 18 19 18 17 17 17 17 17 13 15
11 11 11 11 11 11 11 11 12 16 16 02 00 11 11 11 11 11 11 11 12 16 16 17 17 16 19 16 16 16 19 16 16 16 16 09 16 17 18
02 00 00 00 02 00 00 00 02 16 16 00 00 00 00 02 00 00 00 00 02 16 16 16 16 16 19 16 16 16 19 16 16 16 16 07 16 16 16
00 00 00 00 00 00 00 00 00 16 16 00 00 00 00 00 00 00 00 00 00 16 16 16 16 16 19 16 16 16 19 16 16 16 16 06 16 16 16
16 16 16 16 16 16 16 16 16 16 16 16 16 16 16 16 16 16 16 16 16 16 16 16 16 16 19 16 16 16 19 16 10 11 10 03 10 11 12
04 10 10 11 11 10 03 12 14 15 13 14 15 13 14 15 16 16 16 16 16 16 16 13 14 15 13 14 15 13 14 15 00 02 00 08 00 02 00
08 00 00 00 00 00 07 00 13 13 13 13 13 17 18 17 16 16 16 16 16 16 16 17 18 13 14 15 13 14 15 13 14 15 02 00 00 00 00
02 13 14 15 14 15 08 13 15 14 15 13 14 15 13 14 20 20 20 20 20 20 20 13 14 15 13 14 15 13 14 13 15 13 14 02 13 14 15
15 14 13 14 15 13 02 13 14 15 13 14 15 17 18 17 16 16 16 16 16 16 16 17 18 13 14 15 13 14 15 13 14 13 14 15 14 13 15
13 15 14 13 14 13 15 13 13 14 15 13 14 15 13 14 16 16 16 16 16 16 16 13 14 15 13 14 15 13 14 15 13 14 15 13 15 14 13
01 18 01 18 01 18 01 18 01 18 01 18 01 18 01 18 16 16 16 16 16 16 16 18 01 01 01 01 01 18 01 18 01 01 01 01 01 01 18
