26 10
00 02 00 00 00 00 00 00 00 00 00 00 00 00 00 00 00 00 00 00 00 00 00 00 00 00
00 06 05 05 03 03 05 05 05 05 05 05 05 05 05 05 05 05 05 05 05 05 05 07 05 00
00 05 05 05 06 05 05 05 05 05 06 06 05 05 05 07 05 07 05 05 06 06 05 05 05 00
00 05 05 05 01 01 05 06 05 05 05 05 05 05 05 05 05 05 05 05 05 05 05 05 05 00
00 01 04 01 03 03 05 05 05 05 05 06 05 05 05 05 05 05 05 05 05 05 05 07 05 00
00 03 03 03 03 03 05 05 05 05 05 05 05 05 05 07 05 07 05 05 06 05 05 05 05 00
00 05 05 05 05 05 06 05 05 05 05 05 05 06 06 07 05 05 05 05 05 05 05 05 07 00
00 05 05 06 05 05 05 05 05 05 05 05 05 05 05 05 05 05 05 05 06 05 07 07 05 00
00 05 05 05 05 05 05 05 05 05 06 05 05 05 05 05 05 07 05 05 05 06 05 05 05 00
01 01 01 01 01 01 04 01 01 01 01 01 01 04 01 01 01 01 01 01 04 01 01 01 01 01
