42 31
04 11 11 10 10 11 10 10 11 11 10 10 03 11 11 10 11 11 11 11 11 11 11 11 10 10 10 10 03 11 11 10 11 03 10 03 11 01 03 10 10 03
07 02 00 00 00 00 00 02 00 00 00 00 08 00 00 02 00 00 00 00 00 00 00 00 00 00 02 00 08 02 00 00 00 07 00 07 00 00 07 00 02 07
07 00 00 00 00 00 00 00 13 13 13 13 00 00 00 00 00 00 00 00 00 00 00 00 00 00 00 00 00 00 13 13 13 07 13 07 13 13 07 13 13 07
07 13 13 13 13 13 13 13 13 13 17 17 16 16 00 00 00 00 00 00 00 00 00 00 00 00 00 00 16 16 17 17 13 07 13 07 13 13 07 13 13 07
07 13 13 13 13 13 13 13 13 13 13 13 16 16 16 16 16 16 16 16 16 16 16 16 16 16 16 16 16 16 13 13 13 07 13 08 13 13 07 13 13 07
05 10 11 11 10 11 11 12 13 13 13 13 20 20 20 20 20 20 20 20 20 20 20 20 20 20 20 20 20 20 13 13 13 08 13 02 13 13 08 13 13 07
02 00 00 00 00 00 00 02 13 13 13 13 20 20 20 20 20 20 20 20 20 20 20 20 20 20 20 20 20 20 13 13 13 02 13 13 13 13 02 13 13 08
13 13 13 13 13 13 13 13 13 13 13 13 16 16 16 16 16 16 16 16 19 19 16 16 16 16 16 16 16 16 13 13 13 13 13 13 13 13 13 13 13 02
13 13 17 13 13 13 13 13 13 17 13 13 16 16 16 16 16 16 16 16 19 19 16 16 16 16 16 16 16 16 13 13 17 13 13 13 13 13 13 17 13 13
18 17 16 17 18 13 13 18 17 16 17 18 16 16 16 16 16 16 16 16 19 19 16 16 16 16 16 16 16 16 18 17 16 17 18 13 13 18 17 16 17 18
16 16 16 16 16 19 19 16 16 16 16 16 16 16 09 16 16 16 16 16 19 19 16 16 16 16 09 16 16 16 16 16 16 16 16 19 19 16 16 16 16 16
10 11 11 12 16 19 19 16 16 16 16 16 16 11 03 10 12 16 16 16 19 19 16 16 16 11 03 10 12 16 16 16 16 16 16 19 19 16 04 10 11 11
02 00 00 02 16 19 19 16 16 16 16 16 16 00 08 00 00 13 13 13 13 13 13 13 13 00 08 00 00 16 16 16 16 16 16 19 19 16 08 02 00 02
00 00 00 00 16 19 19 16 16 16 16 16 16 13 00 13 13 13 13 13 13 13 13 13 13 13 00 13 13 16 16 16 16 16 16 19 19 16 00 00 00 00
00 00 00 00 16 19 19 16 16 16 16 16 16 17 13 13 13 13 13 13 13 13 13 13 13 13 13 13 17 16 16 16 16 16 16 19 19 16 00 00 00 00
16 16 16 16 16 19 19 20 20 20 20 20 20 13 13 13 13 13 13 13 13 13 13 13 13 13 13 13 13 20 20 20 20 20 20 19 19 16 16 16 16 16
16 16 16 16 16 19 19 20 20 20 20 20 20 13 13 13 13 13 13 13 13 13 13 13 13 13 13 13 13 20 20 20 20 20 20 19 19 16 09 16 16 16
10 11 11 12 16 19 19 16 16 16 16 16 16 13 13 13 13 17 13 13 13 13 13 13 17 13 13 13 13 16 16 16 16 16 16 19 19 16 05 10 11 10
02 00 00 02 16 19 19 16 16 16 16 16 16 13 13 17 13 16 13 13 13 13 13 13 16 13 13 17 13 16 16 16 16 16 16 19 19 16 02 00 00 02
00 00 00 00 16 19 19 16 16 16 16 16 16 18 17 16 17 16 17 18 13 13 18 17 16 17 17 16 18 16 16 16 16 16 16 19 19 16 00 00 00 00
00 00 00 00 16 19 19 16 09 16 16 16 16 16 16 16 16 16 16 16 19 19 16 16 16 16 16 16 16 16 16 16 09 16 16 19 19 16 00 00 00 00
16 16 16 16 16 19 19 16 06 16 16 16 16 16 16 16 16 16 16 16 19 19 16 16 16 16 16 16 16 16 16 16 05 11 12 19 19 16 16 16 16 16
13 13 13 13 13 13 13 13 07 13 13 13 16 16 16 16 16 16 16 16 19 19 16 16 16 16 16 16 16 16 13 13 00 00 00 13 13 13 13 13 13 13
13 13 13 13 13 13 13 13 06 13 13 18 16 16 16 16 16 16 16 16 19 19 16 16 16 16 16 16 16 16 18 13 13 13 13 13 13 13 13 13 13 13
13 13 04 10 11 10 11 10 03 12 13 13 16 16 16 16 16 16 16 16 19 19 16 16 16 16 16 16 16 16 13 13 13 13 13 13 13 13 13 13 13 13
13 13 06 02 00 00 02 00 08 02 13 13 20 20 20 20 20 20 20 20 20 20 20 20 20 20 20 20 20 20 13 13 13 13 13 13 13 13 13 13 13 13
13 13 07 13 00 13 00 13 02 13 13 13 20 20 20 20 20 20 20 20 20 20 20 20 20 20 20 20 20 20 13 13 13 13 13 13 13 13 13 13 13 13
13 13 08 13 13 13 13 13 00 13 13 13 16 16 16 16 16 16 16 16 19 19 16 16 16 16 16 16 16 16 04 11 11 11 13 13 13 13 13 13 13 13
13 13 02 13 13 13 13 13 13 13 13 18 16 16 16 16 16 16 16 16 19 19 16 16 16 16 04 11 10 10 03 00 02 00 13 13 13 13 13 13 13 13
13 13 13 13 13 13 13 13 13 13 13 13 16 16 16 16 16 16 16 13 13 13 13 16 16 16 08 00 00 00 08 00 13 13 13 13 13 13 13 13 13 13
01 01 01 18 01 01 01 18 01 01 01 18 16 16 16 16 16 16 16 18 01 01 18 16 16 16 02 16 16 16 16 16 18 01 01 01 18 01 01 01 18 01