26 12
04 11 11 10 10 11 10 10 11 11 10 10 03 11 11 10 10 11 10 10 11 11 10 10 10 07
07 00 00 00 00 00 00 00 00 00 00 00 07 00 00 00 00 00 00 00 00 00 00 00 00 07
07 13 13 13 13 13 13 13 13 13 13 13 08 13 13 13 13 13 13 13 13 13 13 13 13 07
07 13 13 13 13 13 13 13 13 13 13 13 00 13 13 13 13 13 13 13 13 13 13 13 13 07
06 13 13 13 13 13 13 13 13 13 13 13 13 13 13 13 13 13 13 13 13 13 13 13 13 06
06 13 13 13 13 13 13 13 13 13 13 13 09 13 13 13 13 13 13 13 13 13 13 13 13 06
03 11 11 13 13 11 11 10 10 11 10 10 03 10 11 11 10 12 13 13 10 10 11 10 10 03
06 00 00 13 13 00 00 00 00 00 00 00 07 00 00 00 00 00 13 13 00 00 00 00 00 06
06 14 15 15 13 14 13 15 14 14 15 13 06 13 13 15 13 14 14 14 13 15 13 13 13 06
08 13 13 15 13 14 14 14 13 15 13 13 08 14 15 15 13 14 13 15 14 14 15 13 13 08
00 13 13 15 13 14 15 14 15 14 13 13 00 13 13 15 13 14 15 14 15 14 13 13 13 00
01 01 01 01 18 01 01 01 01 01 18 01 01 01 01 01 01 01 18 01 01 01 01 01 01 01
